1111111111111111111111
1111001011101110101111
1010101111111111111011
1000000P00000000001111
10111010111D1010111011
1111111011101010001011
1000111011111010111011
10101010111D11D0101011
1110111010001010111011
1000C00C101010000000E1
1111111111111111111111
