11111111111111111111111111111111111111111111
1C0001010D100000C010001000101000000000011C01
101011001100100000010000101000C010D100DDD001
100C100C0C0000001010000001001010000000111D01
100000001000000000D000011100010000001010CD01
100001000P001001100000000110001010001100D101
10010D100000C1000000C11010011000010100000001
1C1000C101011000010000000000010C001DD0001001
1DD1D0DDC1C1001010100100011D0000C0CC010D1101
111000000001000000000C010101000101D000D00001
1000001C10000000000C00000000101100011100C011
1000001DDDD1000000101000000C0000000010000011
11100011000010100000C1000D001100000000000011
1100101011010001001101101000001010D010010001
10011010010000000100100000001C01C00000100111
1110101100000C11000101011000001010001000D011
100101000000010100C0001000001010110000000001
1000C00100000000000111100000011000C001C00001
10100001101100001000011000010D0010DDC0C01101
10101110100010001C00100101000DD0000100000011
10000001100100110101011000000010011010C01C01
10010010001000100100100111010000001110011101
10000000D0010101C001000100010000011101C00111
10000000100100110001010000001C10110101000111
10000000100000000000110100000DD0100001000111
1000000011010000110000000000101100C10000C0C1
1001101010000C00010000E0100010010D0C00000101
1010D001010000000000000110DD00D0000000100011
101001D1000100100100001010001100000100000001
101010D00001CD11001C01011C0001101C0000011C01
10000DDDDD0DD100100100C010C0C00001D0C0000001
10100000000000001001110010010000010000000101
11111111111111111111111111111111111111111111
